NO ./assets/portal_cobblestone.xpm
SO ./assets/portal_stone.xpm
WE ./assets/portal_whiteStone.xpm
EA ./assets/portal_stoneslab_side.xpm

F 255,255,255
C 255,255,255

111111  11111
100001  10001
10N001  10101
100001  10111111
110011  10000001
110011  11110101
1100111111 10001
1000000001110111
10000000000001
10000000011111
1000000001
1000000001
111111110111111
       10000001
       11111101
   111111   101
   100001111101
   100000000001
   111111111111
