NO ./assets/cobblestone.xpm
SO ./assets/Stitch.xpm
WE ./assets/Cat.xpm
EA ./assets/Stitch.xpm

F 220,100,0
C 225,30,0
        1111111111111111111111111
        1000000000110000000000001
        1011000001110000000000001
        1001000000000000000000001
111111111011000001110000000000001
100000000011000001110111111111111
11110111111111011100000010001
1111011111111101110101001011
11000000110101011100000010001
100N0000000000001100000000001
10000000000000001101010010001
1100000111010101111101111000111
11110111 1110101 111111110001
11111111 1111111 111111111111





